###############################
#@ #     #     #     #        #
#  #  #######  ####  #  #######
#  #        #  #              #
#  #  #  ####  #######  #  ####
#     #              #  #  #  #
####  #  ####  #  ####  ####  #
#     #  #     #        #     #
#######  #  #######  #######  #
#     #  #        #  #        #
#  #  #  #  #######  #######  #
#  #     #  #                 #
####  #############  ####  ####
#        #     #     #        #
####  #  #  #  ####  #  ####  #
#     #  #  #     #  #  #     #
#  ##########  #  #  ####  ####
#  #  #        #        #  #  #
#  #  ####  ####  #  #  #  #  #
#        #  #     #  #  #     #
#############################.#