###############################
#     #                 #     #
#### ##### ############   ### #
#  #        #    #     ###  # #
#  #### #####  #######  #  ## #
#        #        #  #     #  #
#######  ####  ####  #  ####  #
#        #     #  #        #  #
#  #  ####  ####  # ## #####  #
#  #  #             #      #  #
####  #### ####  # #  ####### #
#     #    #     # #  #       #
# #####  ### #######  ###### ##
#             #           #   #
#  #  #  # #  ##### # ####### #
#  #  #  # ##@#     #       # #
#######  #  ####  ########### #
#        #  #        #        #
####  ######### ####### ##### #
#               #       #     #
#################.#############