#############################.#
#                             #
# #############################
#                             #
############################# #
#                             #
# #############################
#                             #
############################# #
#                             #
# #############################
#                             #
############################# #
#                             #
# #############################
#                             #
############################# #
#                             #
# #############################
#                            @#
###############################
