###############################
.  #        #                 #
#  #  #######  #  ####  #######
#        #     #  #  #  #     #
#  ####  #  #  #  #  #  #  ####
#  #        #  #     #     #  #
####  #  ##########  #######  #
#     #     #                 #
#######  #######  #############
#        #                 #  #
#######  #  #######  #######  #
#     #  #        #  #        #
#  #######  ##########  ####  #
#  #        #  #     #  #     #
#  #######  #  #  #######  ####
#  #  #                 #     #
#  #  #  #############  ####  #
#           #  #        # @   #
####  #  ####  ####  #######  #
#     #     #                 #
###############################  