###############################
#                             #
####  #  ####  ########### ####
#     #  #     #           #  #
#  #  ####  #######  #######  #
#  #  #     #     #           #
#  ##########  #######  #######
#  #        #        #        #
#  ####  #######  ####  #######
#  #        #     #        #  #
#  #  #  #######  #  #######  #
#     #  #     #     #        #
####  #  #  ####  ####  ####  #
#  #  #     #  #     #  #     #
#  #  #  ####  #  ####  ####  #
#     #  #     #        #  #  #
#######  ####  #  ####  #  #  #
#        #        #     #     #
# ##  ############# ########  #
#@#              #     #      #
########################.######