###############################
#                             #
# ##############  #  #  #######
#  #  #        #  #  #        #
#  #  #  ####  #############  #
#  #        #           #  #  #
## #  #######  ##########  #  #
#  #  #  #        #     #  #  #
#  #  #  #  #  #  #  ####  #  #
#  #     #  #  #  #     #     #
#  #############  ####  #  ####
#  #                 #        #
#  #############  #  ##### ####
#              #  #           #
#  #######  ####  ####  ####  #
#  #     #     #    @#  #     #
####  ####  #  #######  #######
#        #  #  #  #     #     #
#  #  ####  #  #  #  ####  ####
#  #        #     #           #
#.#############################  